
# # # # # # # # 
# @ . . . # . # 
# . # # # # ERed # 
# . . . . . . # 
# # # # # # # # 